*...........................
*...........................
#%%#%%#%#*######%...........
.........*..................
.........*..................
.........*....##*...........
.........*....##*...........
.........*....##*...###*####
.........*....##*......*....
.........*....##*......*....
.........*....##*......*....
###*######....######*#######
...*................*.......
...*................*.......
...*................*.......
############*#######*.......
............*.......*.......
............*.......*.......
............*.......*.......
.....*########......#######*
.....*.....................*
.....*.....................*
############################
%%%%%%%%%%%%%%%%%%%%%%%%%%%%