...........................*
...........................*
...........................*
....................*######*
....................*......*
....................*......*
#####*#...#*###.....*......*
.....*.....*....####*#######
.....*.....*........*.......
.....*.....*........*.......
#####*###..*........*.......
.....*.....*........*.......
.....*.....*........*.......
.....*.....*........*.......
##*###########*.....*.####.*
..*...........*.....*.####.*
..*...........*.....*.#..#.*
..*...........*.....*.#..#.*
########*...........*.#####*
........*...........*......*
........*...........*......*
........*...........*......*
############################
%%%%%%%%%%%%%%%%%%%%%%%%%%%%