*...........................
*.....!.....................
#%%#%%#%#*######%...........
.........*..................
.........*..................
.........*....##*...........
.........*....##*...........
.........*....##*...###*####
.........*....##*......*....
.........*....##*......*....
.........*....##*......*....
###*######....######*#######
...*................*.......
...*................*.......
...*.....!..........*.......
############*#######*.......
............*.......*.......
............*.......*.......
......!.....*.......*.......
.....*########......#######*
.....*.....................*
.....*....................@*
############################
%%%%%%%%%%%%%%%%%%%%%%%%%%%%