...........................*
...........................*
...........................*
....................*######*
....................*......*
....................*......*
#####*#...#*###..!..*......*
.....*.....*....####*#######
.....*.....*........*.......
.....*.....*........*.......
#####*###..*........*.......
.....*.....*........*.......
.....*.....*........*.......
.....*.!...*........*.......
##*###########*.....*.####.*
..*...........*.....*.####.*
..*...........*.....*.#..#.*
..*.!.........*.....*.#..#.*
########*...........*.#####*
........*...........*......*
........*...........*......*
........*...........*....@.*
############################
%%%%%%%%%%%%%%%%%%%%%%%%%%%%