...........................*
...........................*
...........................*
...........................*
*%%#%%*....................*
*.....*....*########*......*
*.....*....*........*######*
*.....*....*........*.......
*#%#%#*....*........*.......
*.....*....*........*.......
*.....*....*.....*###%%%%%%*
*.....*....*.....*.........*
*.....*....*.....*.........*
*.....*....*#####*.........*
%###%##%##%*........*####*##
%###%......*........*....*..
%...%......*........*....*..
%...%......*........*....*..
#######*####%%%.....*..#####
.......*............*.......
.......*............*.......
.......*............*.......
############################
%%%%%%%%%%%%%%%%%%%%%%%%%%%%