...........................*
...........................*
...........................*
..!........................*
*%%#%%*......!.............*
*.....*....*########*......*
*.....*....*........*######*
*.....*....*........*.......
*#%#%#*....*........*.......
*.....*....*........*.......
*.....*....*.....*###%%%%%%*
*.....*....*.....*.........*
*.....*....*.....*.........*
*.....*....*#####*.....!...*
%###%##%##%*........*####*##
%###%......*........*....*..
%...%......*........*....*..
%...%......*........*....*..
#######*####%%%.....*..#####
.......*............*.......
.......*............*.......
.......*............*.....@.
############################
%%%%%%%%%%%%%%%%%%%%%%%%%%%%